title	tags
How to draw a stacked dotplot in R?	['r']
mysql select all records where a datetime field is less than a specified value	['php', 'mysql']
How to terminate windows phone 8.1 app	['c#']
get current time in a specific country via jquery	['javascript', 'jquery']
Configuring Tomcat to Use SSL	['java']
Awesome nested set plugin - how to add new children to the tree at various levels	['ruby-on-rails']
How to create map from JSON response in Ruby on Rails 3?	['ruby', 'ruby-on-rails-3', 'json']
rspec test if method is called	['ruby']
SpringBoot Catalina LifeCycle Exception	['java', 'spring', 'spring-mvc']
How to import data from excel to mysql database using php	['php', 'codeigniter']
Obtaining the object the java.lang.Class<T> object for a parameterized type without constructing the class in q_uestion?	['java', 'class']
iPad not selecting all text inside a text input on tap	['javascript', 'jquery', 'html', 'ios']
How is jQuery's $ a function and an object?	['javascript', 'jquery']
Eclipse C++ MinGW - Can not Lauch Program <Terminated>	['c++', 'eclipse']
In javascript how can I call one prototype method in another prototype method?	['javascript']
get intersection of list of sets	['python', 'list']
No longer able to hide keyboard during viewWillDisappear in iOS7	['ios', 'objective-c']
How to fetch the key from JSON in Swift?	['ios', 'json', 'swift']
How to Change Pivot Header Template in Windows Phone 8	['c#', 'xaml']
connectionString encryption	['c#', 'asp.net']
How to let the UI refresh during a long running *UI* operation	['c#', 'wpf', 'multithreading']
Better way to execute ruby file using Python and How to get ruby console output when ruby file is run from python?	['python', 'ruby']
make 2 thumbnails at once in codeigniter	['php', 'image', 'codeigniter']
Java Character vs char: what about memory usage?	['java', 'performance']
Bootstrap modal close on enter key press	['javascript', 'jquery', 'twitter-bootstrap']
Linq query with group by retrieving percentage	['c#', 'linq']
Label field issue - OpenErp	['python', 'xml']
How to keep 2 objects in view at all time by scaling the field of view? (or z&y axis)	['c#']
AttributeError: 'NoneType' object has no attribute 'split'	['python']
How to append to .mat file using scipy.io.savemat?	['python', 'numpy']
JQuery replace onClick in h:commandLink	['javascript', 'jquery']
How to redirect output of Ruby programme to some file	['ruby']
No 'Access-Control-Allow-Origin' header is present on the requested resource error	['javascript', 'jquery', 'ajax', 'json']
Creating JSON in Windows 8 C# using IJsonValue: Cannot Implicitly convert type 'string' to 'Windows.Data.Json.IJsonValue'	['c#', 'json']
Django ModelForm label captialisation	['django']
how to do show/hide div with slide in Javascript (without jQuery)	['javascript']
How to avoid busy spinning in Java	['java', 'multithreading']
Laravel 4: Input::all() returns no data with $.ajax POST	['php', 'jquery', 'ajax', 'laravel']
How to handle net::ERR_CONNECTION_REFUSED in jquery ajax	['javascript', 'jquery', 'ajax']
Year Function in R	['r']
How to use retrofit as a singleton while using gson convertor?	['java', 'android', 'rest']
How do I use SetTimer in non-dialog .cpp in my mfc app?	['c++']
Copying a web reference to a new project	['c#', 'asp.net', 'asp.net-mvc', 'web-services']
LINQ query to select top five	['c#', 'linq']
JavaScript: How can I insert a string at a specific index	['javascript', 'string']
Apache POI: change page format for Excel worksheet	['java', 'excel']
Python Tkinter indeterminate progress bar not running	['python']
how to store image path in mysql database using C#	['c#', 'mysql', 'winforms']
jdbc connection error: not associated with a managed connection	['java']
How to use multiple tables in one model in yii2	['php', 'mysql']
Get All Controller Names in ASP.NET MVC4	['c#', 'asp.net', 'asp.net-mvc']
casting integer array to object array in java	['java', 'arrays']
Getting error in uploading file in php	['php']
clear() methods in Java	['java']
Printing floats with a specific number of zeros	['python']
Simple C/C++ network I/O library	['c++', 'c', 'sockets']
Running Ruby from usr/bin instead of usr/local/bin?	['ruby-on-rails', 'osx']
Bitmap in C, binary operations	['c']
Laravel default mail not working	['php', 'laravel']
Entity Framework Model Distinct Function	['c#', 'asp.net', 'entity-framework']
ExtJS how to get checked nodes on submit?	['javascript']
Linq Select nested lists	['c#', 'linq', 'list', 'mongodb']
How to show and hide an element, pass values from javascript to html element using JavaScript (not jQuery)?	['javascript', 'html']
How can i get information from JSON dictionary in java	['java', 'json']
jQUery .slideToggle() & .text replace	['javascript', 'jquery']
Display image created by OpenCV on Android	['android', 'c++', 'opencv']
Instantiating class by string in current namespace	['php']
WPF and Screen Resolution	['c#', 'wpf']
Content of static table view cell not displayed iOS 9	['ios', 'xcode', 'swift', 'uitableview']
What is the best autocomplete/suggest algorithm,datastructure [C++/C]	['c++', 'c', 'algorithm']
Backbone model.save() is sending PUT instead of POST	['javascript']
'window.location.replace' redirects to the given page but destroies the session from php (Chrome only)?	['php', 'javascript', 'ajax']
MVC 4 Razor: Model missing collections when I use a form post	['c#', 'asp.net-mvc']
Apache POI date dd.MM.yyyy	['java']
Change the style of one dynamically created LinkButton while not affecting others?	['c#', 'asp.net']
How can I check if a point is below a line or not?	['python']
python client request fails with default timeout	['python', 'python-2.7']
Simultaneously acquire data and update graph using python and matplotlib	['python', 'multithreading']
Store value into string array	['java', 'android', 'arrays']
C# DataTable Inner join with dynamic columns	['c#']
The correct realization of the adapter pattern in objective c	['ios', 'objective-c']
How to save an image to another folder using ajax and jquery	['javascript', 'jquery', 'ajax', 'spring-mvc']
When should I use function currying in Python?	['python']
jquery DataTables.net plugin: how to ignore specific rows when sorting	['javascript', 'jquery', 'html']
How to get current dom element in angular directive	['javascript', 'angularjs', 'dom']
Draw rectangles next to each other in Java	['java', 'swing']
Getting all parameters from URL in Zend	['php']
Template inheritance inner class access problem	['c++', 'class']
ValueError: time data '2012-07-19 08:24:00' does not match format '%Y-%m-%d H:M:S'	['python']
Passing an array of JSON objects trough sockets in Java	['java', 'json', 'sockets']
Missing child nodes when deserializing XML to object	['c#', '.net', 'xml']
"Error when uploading new iPad app version: ""iPad: application executable contains unsupported architecture(s): i386"""	['objective-c', 'xcode', 'ios']
Passing an array using COM?	['c++']
Getting urllib2.URLError: <urlopen error [Errno 10061] Error	['python']
Unique Combination of Set	['vb.net']
bind drop down list using jquery ajax on change of first ddl	['c#', 'jquery', 'asp.net']
Rails 3.1 Qeurying the database encrypted with attr_encrypted gem (where clause on encrypted fields)	['mysql', 'ruby-on-rails', 'ruby-on-rails-3']
ListCtrl Hack: Set a ListItems Text in a ListCtrl	['python']
PHP, MySQL, and Google Maps API Generate POI by City and State Name?	['php', 'javascript', 'mysql', 'google-maps']
: mappedBy reference an unknown target entity property	['java', 'spring', 'hibernate']
